7 10
4 4 4 4 4 4 4 4 4 4
4 4 4 4 0 0 0 0 4 4
4 4 2 0 1 4 4 0 4 4
4 2 2 1 0 1 0 0 0 4
4 2 2 0 1 0 1 0 4 4
4 4 4 4 4 4 0 0 4 4
4 4 4 4 4 4 4 4 4 4
4 9