7 8
4 4 4 4 4 4 4 4
4 0 0 4 0 0 0 4
4 0 1 2 2 1 0 4
4 0 1 2 3 0 4 4
4 0 1 2 2 1 0 4
4 0 0 4 0 0 0 4
4 4 4 4 4 4 4 4
4 2
