9 11
4 4 4 4 4 4 4 4 4 4 4
4 4 0 0 4 4 0 0 0 4 4
4 4 0 0 0 1 0 0 0 4 4
4 4 1 0 4 4 4 0 1 4 4
4 4 0 4 2 2 2 4 0 4 4
4 4 0 4 2 2 2 4 0 4 4
4 0 1 0 0 1 0 0 1 0 4
4 0 0 0 0 0 4 0 0 0 4
4 4 4 4 4 4 4 4 4 4 4
8 9
