6 12
4 4 4 4 4 0 0 4 4 4 4 4
4 4 0 0 4 4 4 4 0 0 0 4
4 0 1 0 4 4 4 4 1 0 0 4
4 0 0 1 2 2 2 2 0 1 0 4
4 4 0 0 0 0 4 0 0 0 4 4
4 4 4 4 4 4 4 4 4 4 4 4
5 9
